NO ./game_assets/colorstone.xpm
SO ./game_assets/greystone.xpm

WE ./game_assets/mossy.xpm

C 135,206,255

 EA ./game_assets/redbrick.xpm  


F 92,64,90

111111111111111111111111
100000000011000000000001
1011000001110000000000001
100100000000000000000000111111111111
111111111011000001110000000000001
100000000011000001110111110111111
11110111111111011100000010001
11110111111111011101000010001
11000000110101011100000001N001
10000000000000001100000010001
10000000000000001101010010001
110000011101010111110111100111
11110111 1110101 101111010001
11111111 1111111 111111111111